Adlercreutzia_equolifaciens	Eubacterium_rectale,Campylobacter_jejuni
Campylobacter_jejuni	Odoribacter_splanchnicus,Bifidobacterium_catenulatum,Eubacterium_rectale,Adlercreutzia_equolifaciens
Bacteroides_thetaiotaomicron	Eubacterium_rectale,Oxalobacter_formigenes
Oxalobacter_formigenes	Eubacterium_rectale,Bacteroides_thetaiotaomicron
Bifidobacterium_catenulatum	Eubacterium_rectale,Campylobacter_jejuni
Eubacterium_rectale	Parabacteroides_distasonis,Lactococcus_lactis,Bacteroides_ovatus,Bacteroides_caccae,Flavonifractor_plautii,Bifidobacterium_catenulatum,Eubacterium_hallii,Bifidobacterium_adolescentis,Blautia_hansenii,Streptococcus_salivarius,Enterococcus_faecium,Escherichia_coli,Ruminococcus_champanellensis,Campylobacter_jejuni,Roseburia_hominis,Bacteroides_dorei,Ruminococcus_albus,Alistipes_shahii,Bifidobacterium_kashiwanohense,Streptococcus_thermophilus,Eubacterium_cellulosolvens,Bifidobacterium_animalis,Alistipes_finegoldii,Bacteroides_thetaiotaomicron,Bacteroides_cellulosilyticus,Ruminococcus_bicirculans,Oxalobacter_formigenes,Bifidobacterium_longum,Odoribacter_splanchnicus,Anaerostipes_hadrus,Clostridium_difficile,Eubacterium_eligens,Desulfovibrio_piger,Bacteroides_fragilis,Streptococcus_agalactiae,Campylobacter_coli,Bacteroides_vulgatus,Adlercreutzia_equolifaciens,Clostridium_bolteae,Eubacterium_limosum
Alistipes_finegoldii	Eubacterium_rectale
Alistipes_shahii	Eubacterium_rectale
Anaerostipes_hadrus	Eubacterium_rectale
Bacteroides_caccae	Eubacterium_rectale
Bacteroides_cellulosilyticus	Eubacterium_rectale
Bacteroides_dorei	Eubacterium_rectale
Bacteroides_fragilis	Eubacterium_rectale
Bacteroides_ovatus	Eubacterium_rectale
Bacteroides_vulgatus	Eubacterium_rectale
Bifidobacterium_adolescentis	Eubacterium_rectale
Bifidobacterium_animalis	Eubacterium_rectale
Bifidobacterium_kashiwanohense	Eubacterium_rectale
Bifidobacterium_longum	Eubacterium_rectale
Blautia_hansenii	Eubacterium_rectale
Campylobacter_coli	Eubacterium_rectale
Clostridium_bolteae	Eubacterium_rectale
Clostridium_difficile	Eubacterium_rectale
Desulfovibrio_piger	Eubacterium_rectale
Enterococcus_faecium	Eubacterium_rectale
Escherichia_coli	Eubacterium_rectale
Eubacterium_cellulosolvens	Eubacterium_rectale
Eubacterium_eligens	Eubacterium_rectale
Eubacterium_hallii	Eubacterium_rectale
Eubacterium_limosum	Flavonifractor_plautii,Roseburia_hominis,Eubacterium_rectale,Streptococcus_agalactiae
Flavonifractor_plautii	Eubacterium_rectale,Eubacterium_limosum
Lactococcus_lactis	Eubacterium_rectale,Ruminococcus_albus
Odoribacter_splanchnicus	Eubacterium_rectale,Campylobacter_jejuni
Parabacteroides_distasonis	Eubacterium_rectale,Ruminococcus_albus
Roseburia_hominis	Eubacterium_rectale,Eubacterium_limosum
Ruminococcus_albus	Parabacteroides_distasonis,Eubacterium_rectale,Lactococcus_lactis
Ruminococcus_bicirculans	Eubacterium_rectale
Ruminococcus_champanellensis	Eubacterium_rectale
Streptococcus_agalactiae	Eubacterium_rectale,Eubacterium_limosum
Streptococcus_salivarius	Eubacterium_rectale
Streptococcus_thermophilus	Eubacterium_rectale
