Adlercreutzia_equolifaciens	Lactobacillus_rhamnosus,Eubacterium_rectale,Bacteroides_vulgatus,Blautia_hansenii
Blautia_hansenii	Flavonifractor_plautii,Bifidobacterium_adolescentis,Roseburia_hominis,Veillonella_parvula,Bacteroides_vulgatus,Eubacterium_rectale,Adlercreutzia_equolifaciens,Clostridium_bolteae
Lactobacillus_rhamnosus	Parabacteroides_distasonis,Bacteroides_ovatus,Bacteroides_caccae,Flavonifractor_plautii,Bifidobacterium_catenulatum,Eubacterium_hallii,Streptococcus_salivarius,Enterococcus_faecium,Ruminococcus_champanellensis,Bifidobacterium_pseudocatenulatum,Roseburia_hominis,Veillonella_parvula,Bifidobacterium_kashiwanohense,Streptococcus_thermophilus,Eubacterium_cellulosolvens,Alistipes_finegoldii,Haemophilus_parainfluenzae,Ruminococcus_bicirculans,Bifidobacterium_longum,Odoribacter_splanchnicus,Anaerostipes_hadrus,Eubacterium_eligens,Bacteroides_fragilis,Eubacterium_rectale,Adlercreutzia_equolifaciens,Clostridium_bolteae,Eubacterium_limosum
Alistipes_finegoldii	Lactobacillus_rhamnosus,Eubacterium_rectale,Bacteroides_vulgatus,Eubacterium_limosum
Eubacterium_limosum	Alistipes_finegoldii,Flavonifractor_plautii,Ruminococcus_champanellensis,Bacteroides_cellulosilyticus,Streptococcus_parasanguinis,Lactobacillus_rhamnosus,Bacteroides_dorei,Bifidobacterium_longum,Anaerostipes_hadrus,Enterococcus_faecium,Eubacterium_rectale
Anaerostipes_hadrus	Eubacterium_cellulosolvens,Ruminococcus_champanellensis,Haemophilus_parainfluenzae,Lactobacillus_rhamnosus,Veillonella_parvula,Bacteroides_vulgatus,Eubacterium_rectale,Eubacterium_limosum
Eubacterium_cellulosolvens	Parabacteroides_distasonis,Bacteroides_ovatus,Bifidobacterium_catenulatum,Eubacterium_hallii,Ruminococcus_champanellensis,Bifidobacterium_adolescentis,Lactobacillus_rhamnosus,Roseburia_hominis,Bacteroides_dorei,Streptococcus_parasanguinis,Odoribacter_splanchnicus,Anaerostipes_hadrus,Eubacterium_rectale
Haemophilus_parainfluenzae	Flavonifractor_plautii,Anaerostipes_hadrus,Lactobacillus_rhamnosus,Eubacterium_rectale
Ruminococcus_champanellensis	Eubacterium_cellulosolvens,Lactobacillus_rhamnosus,Streptococcus_parasanguinis,Anaerostipes_hadrus,Eubacterium_limosum,Eubacterium_rectale
Veillonella_parvula	Flavonifractor_plautii,Bifidobacterium_adolescentis,Lactobacillus_rhamnosus,Blautia_hansenii,Bacteroides_dorei,Streptococcus_parasanguinis,Bifidobacterium_kashiwanohense,Anaerostipes_hadrus,Eubacterium_rectale
Bacteroides_caccae	Lactobacillus_rhamnosus,Eubacterium_rectale,Bifidobacterium_pseudocatenulatum,Bacteroides_vulgatus
Bifidobacterium_pseudocatenulatum	Bacteroides_caccae,Bifidobacterium_catenulatum,Bifidobacterium_adolescentis,Lactobacillus_rhamnosus,Streptococcus_parasanguinis,Streptococcus_thermophilus,Eubacterium_rectale
Bacteroides_cellulosilyticus	Eubacterium_rectale,Bacteroides_vulgatus,Eubacterium_limosum
Bacteroides_dorei	Eubacterium_cellulosolvens,Veillonella_parvula,Bacteroides_vulgatus,Eubacterium_rectale,Eubacterium_limosum
Bacteroides_fragilis	Lactobacillus_rhamnosus,Eubacterium_rectale,Bacteroides_vulgatus
Bacteroides_ovatus	Lactobacillus_rhamnosus,Eubacterium_rectale,Bacteroides_vulgatus,Eubacterium_cellulosolvens
Bacteroides_thetaiotaomicron	Eubacterium_rectale,Bacteroides_vulgatus,Streptococcus_parasanguinis
Streptococcus_parasanguinis	Bacteroides_thetaiotaomicron,Ruminococcus_champanellensis,Bifidobacterium_pseudocatenulatum,Veillonella_parvula,Bacteroides_vulgatus,Eubacterium_limosum,Eubacterium_rectale,Eubacterium_cellulosolvens
Bacteroides_vulgatus	Parabacteroides_distasonis,Bacteroides_ovatus,Bacteroides_caccae,Flavonifractor_plautii,Bifidobacterium_catenulatum,Eubacterium_hallii,Bifidobacterium_adolescentis,Blautia_hansenii,Streptococcus_salivarius,Roseburia_hominis,Bacteroides_dorei,Streptococcus_parasanguinis,Streptococcus_thermophilus,Alistipes_finegoldii,Bacteroides_thetaiotaomicron,Bacteroides_cellulosilyticus,Ruminococcus_bicirculans,Bifidobacterium_longum,Odoribacter_splanchnicus,Clostridium_difficile,Anaerostipes_hadrus,Eubacterium_eligens,Bacteroides_fragilis,Eubacterium_rectale,Adlercreutzia_equolifaciens,Clostridium_bolteae
Bifidobacterium_adolescentis	Bifidobacterium_pseudocatenulatum,Blautia_hansenii,Veillonella_parvula,Bacteroides_vulgatus,Eubacterium_rectale,Eubacterium_cellulosolvens
Bifidobacterium_catenulatum	Bifidobacterium_pseudocatenulatum,Lactobacillus_rhamnosus,Bacteroides_vulgatus,Eubacterium_rectale,Eubacterium_cellulosolvens
Bifidobacterium_longum	Lactobacillus_rhamnosus,Eubacterium_limosum,Eubacterium_rectale,Bacteroides_vulgatus
Clostridium_bolteae	Lactobacillus_rhamnosus,Eubacterium_rectale,Bacteroides_vulgatus,Blautia_hansenii
Clostridium_difficile	Eubacterium_rectale,Bacteroides_vulgatus
Eubacterium_eligens	Lactobacillus_rhamnosus,Eubacterium_rectale,Bacteroides_vulgatus
Eubacterium_hallii	Lactobacillus_rhamnosus,Eubacterium_rectale,Eubacterium_cellulosolvens,Bacteroides_vulgatus
Eubacterium_rectale	Parabacteroides_distasonis,Bacteroides_ovatus,Bacteroides_caccae,Flavonifractor_plautii,Bifidobacterium_catenulatum,Eubacterium_hallii,Bifidobacterium_adolescentis,Blautia_hansenii,Streptococcus_salivarius,Enterococcus_faecium,Ruminococcus_champanellensis,Bifidobacterium_pseudocatenulatum,Roseburia_hominis,Bacteroides_dorei,Veillonella_parvula,Streptococcus_parasanguinis,Alistipes_shahii,Bifidobacterium_kashiwanohense,Streptococcus_thermophilus,Eubacterium_cellulosolvens,Alistipes_finegoldii,Bacteroides_thetaiotaomicron,Bacteroides_cellulosilyticus,Haemophilus_parainfluenzae,Ruminococcus_bicirculans,Bifidobacterium_longum,Odoribacter_splanchnicus,Clostridium_difficile,Anaerostipes_hadrus,Eubacterium_eligens,Bacteroides_fragilis,Lactobacillus_rhamnosus,Bacteroides_vulgatus,Adlercreutzia_equolifaciens,Clostridium_bolteae,Eubacterium_limosum
Flavonifractor_plautii	Parabacteroides_distasonis,Haemophilus_parainfluenzae,Blautia_hansenii,Lactobacillus_rhamnosus,Veillonella_parvula,Bacteroides_vulgatus,Eubacterium_limosum,Eubacterium_rectale,Enterococcus_faecium
Odoribacter_splanchnicus	Lactobacillus_rhamnosus,Eubacterium_rectale,Eubacterium_cellulosolvens,Bacteroides_vulgatus
Parabacteroides_distasonis	Flavonifractor_plautii,Lactobacillus_rhamnosus,Bacteroides_vulgatus,Eubacterium_rectale,Eubacterium_cellulosolvens
Roseburia_hominis	Blautia_hansenii,Lactobacillus_rhamnosus,Bacteroides_vulgatus,Eubacterium_rectale,Eubacterium_cellulosolvens
Ruminococcus_bicirculans	Lactobacillus_rhamnosus,Eubacterium_rectale,Bacteroides_vulgatus
Streptococcus_salivarius	Lactobacillus_rhamnosus,Eubacterium_rectale,Bacteroides_vulgatus
Streptococcus_thermophilus	Lactobacillus_rhamnosus,Eubacterium_rectale,Bifidobacterium_pseudocatenulatum,Bacteroides_vulgatus
Bifidobacterium_kashiwanohense	Lactobacillus_rhamnosus,Eubacterium_rectale,Veillonella_parvula
Enterococcus_faecium	Lactobacillus_rhamnosus,Flavonifractor_plautii,Eubacterium_rectale,Eubacterium_limosum
Alistipes_shahii	Eubacterium_rectale
