Adlercreutzia_equolifaciens	Bifidobacterium_animalis,Alistipes_finegoldii,Odoribacter_splanchnicus,Bacteroides_fragilis,Campylobacter_coli,Alistipes_shahii,Eubacterium_rectale
Alistipes_finegoldii	Bacteroides_ovatus,Flavonifractor_plautii,Bifidobacterium_catenulatum,Eubacterium_hallii,Bifidobacterium_adolescentis,Ruminococcus_champanellensis,Bacteroides_dorei,Streptococcus_parasanguinis,Bifidobacterium_kashiwanohense,Eubacterium_cellulosolvens,Bifidobacterium_bifidum,Bacteroides_thetaiotaomicron,Odoribacter_splanchnicus,Bacteroides_fragilis,Campylobacter_coli,Bacteroides_vulgatus,Gordonibacter_pamelaeae,Eubacterium_rectale,Adlercreutzia_equolifaciens,Clostridium_bolteae
Alistipes_shahii	Bacteroides_thetaiotaomicron,Bacteroides_fragilis,Blautia_hansenii,Eubacterium_rectale,Adlercreutzia_equolifaciens
Bacteroides_fragilis	Alistipes_finegoldii,Bacteroides_thetaiotaomicron,Odoribacter_splanchnicus,Campylobacter_coli,Alistipes_shahii,Eubacterium_rectale,Adlercreutzia_equolifaciens,Clostridium_bolteae
Bifidobacterium_animalis	Bifidobacterium_catenulatum,Campylobacter_coli,Eubacterium_rectale,Adlercreutzia_equolifaciens,Bifidobacterium_breve
Campylobacter_coli	Parabacteroides_distasonis,Bacteroides_ovatus,Eubacterium_hallii,Bifidobacterium_adolescentis,Blautia_hansenii,Enterococcus_faecium,Ruminococcus_champanellensis,Bacteroides_dorei,Streptococcus_parasanguinis,Bifidobacterium_kashiwanohense,Eubacterium_cellulosolvens,Bifidobacterium_animalis,Bifidobacterium_bifidum,Alistipes_finegoldii,Bacteroides_cellulosilyticus,Odoribacter_splanchnicus,Bacteroides_fragilis,Gordonibacter_pamelaeae,Eubacterium_rectale,Adlercreutzia_equolifaciens,Clostridium_bolteae
Odoribacter_splanchnicus	Alistipes_finegoldii,Bacteroides_ovatus,Bacteroides_fragilis,Bifidobacterium_adolescentis,Blautia_hansenii,Campylobacter_coli,Bacteroides_dorei,Streptococcus_parasanguinis,Bifidobacterium_kashiwanohense,Eubacterium_rectale,Adlercreutzia_equolifaciens,Clostridium_bolteae
Blautia_hansenii	Odoribacter_splanchnicus,Haemophilus_parainfluenzae,Campylobacter_coli,Bacteroides_vulgatus,Alistipes_shahii,Clostridium_difficile,Eubacterium_rectale
Anaerostipes_hadrus	Flavonifractor_plautii,Eubacterium_rectale
Flavonifractor_plautii	Alistipes_finegoldii,Bacteroides_caccae,Bifidobacterium_longum,Anaerostipes_hadrus,Eubacterium_rectale
Bacteroides_caccae	Flavonifractor_plautii,Ruminococcus_champanellensis,Eubacterium_rectale
Ruminococcus_champanellensis	Bifidobacterium_bifidum,Alistipes_finegoldii,Bacteroides_caccae,Campylobacter_coli,Eubacterium_rectale,Bifidobacterium_breve
Bacteroides_cellulosilyticus	Eubacterium_rectale,Campylobacter_coli
Bacteroides_dorei	Bifidobacterium_bifidum,Alistipes_finegoldii,Campylobacter_coli,Odoribacter_splanchnicus,Eubacterium_rectale,Bifidobacterium_breve
Bifidobacterium_bifidum	Alistipes_finegoldii,Ruminococcus_champanellensis,Haemophilus_parainfluenzae,Campylobacter_coli,Bifidobacterium_adolescentis,Roseburia_hominis,Bacteroides_dorei,Gordonibacter_pamelaeae,Eubacterium_rectale
Bifidobacterium_breve	Bifidobacterium_animalis,Ruminococcus_champanellensis,Bacteroides_dorei,Eubacterium_rectale,Clostridium_bolteae
Bacteroides_thetaiotaomicron	Alistipes_finegoldii,Bacteroides_fragilis,Alistipes_shahii,Eubacterium_rectale,Clostridium_bolteae
Bacteroides_ovatus	Odoribacter_splanchnicus,Eubacterium_rectale,Alistipes_finegoldii,Campylobacter_coli
Bacteroides_vulgatus	Eubacterium_rectale,Alistipes_finegoldii,Blautia_hansenii
Bifidobacterium_adolescentis	Bifidobacterium_bifidum,Alistipes_finegoldii,Campylobacter_coli,Odoribacter_splanchnicus,Eubacterium_rectale
Bifidobacterium_catenulatum	Bifidobacterium_animalis,Eubacterium_rectale,Alistipes_finegoldii
Bifidobacterium_kashiwanohense	Alistipes_finegoldii,Campylobacter_coli,Odoribacter_splanchnicus,Eubacterium_rectale,Eubacterium_cellulosolvens
Eubacterium_cellulosolvens	Parabacteroides_distasonis,Alistipes_finegoldii,Bifidobacterium_pseudocatenulatum,Campylobacter_coli,Bifidobacterium_kashiwanohense,Eubacterium_rectale,Clostridium_bolteae
Bifidobacterium_longum	Flavonifractor_plautii,Eubacterium_rectale
Clostridium_bolteae	Alistipes_finegoldii,Bacteroides_thetaiotaomicron,Eubacterium_cellulosolvens,Bacteroides_fragilis,Campylobacter_coli,Odoribacter_splanchnicus,Eubacterium_rectale,Bifidobacterium_breve
Clostridium_difficile	Eubacterium_rectale,Gordonibacter_pamelaeae,Blautia_hansenii
Gordonibacter_pamelaeae	Bifidobacterium_bifidum,Alistipes_finegoldii,Campylobacter_coli,Clostridium_difficile,Eubacterium_rectale
Enterococcus_faecium	Eubacterium_rectale,Campylobacter_coli
Bifidobacterium_pseudocatenulatum	Eubacterium_rectale,Eubacterium_cellulosolvens
Eubacterium_hallii	Eubacterium_rectale,Alistipes_finegoldii,Campylobacter_coli
Eubacterium_rectale	Parabacteroides_distasonis,Bacteroides_ovatus,Bacteroides_caccae,Flavonifractor_plautii,Bifidobacterium_catenulatum,Eubacterium_hallii,Bifidobacterium_adolescentis,Blautia_hansenii,Streptococcus_salivarius,Enterococcus_faecium,Ruminococcus_champanellensis,Bifidobacterium_pseudocatenulatum,Roseburia_hominis,Bacteroides_dorei,Streptococcus_parasanguinis,Alistipes_shahii,Bifidobacterium_kashiwanohense,Eubacterium_cellulosolvens,Bifidobacterium_animalis,Bifidobacterium_bifidum,Alistipes_finegoldii,Bacteroides_thetaiotaomicron,Bacteroides_cellulosilyticus,Haemophilus_parainfluenzae,Ruminococcus_bicirculans,Bifidobacterium_longum,Odoribacter_splanchnicus,Anaerostipes_hadrus,Clostridium_difficile,Eubacterium_eligens,Bacteroides_fragilis,Campylobacter_coli,Bacteroides_vulgatus,Gordonibacter_pamelaeae,Adlercreutzia_equolifaciens,Clostridium_bolteae,Bifidobacterium_breve
Eubacterium_eligens	Eubacterium_rectale
Haemophilus_parainfluenzae	Eubacterium_rectale,Bifidobacterium_bifidum,Blautia_hansenii
Parabacteroides_distasonis	Eubacterium_rectale,Eubacterium_cellulosolvens,Campylobacter_coli
Roseburia_hominis	Eubacterium_rectale,Bifidobacterium_bifidum
Ruminococcus_bicirculans	Eubacterium_rectale
Streptococcus_parasanguinis	Odoribacter_splanchnicus,Eubacterium_rectale,Alistipes_finegoldii,Campylobacter_coli
Streptococcus_salivarius	Eubacterium_rectale
